{
  "start":
  {
    "level":  [
                [18,  6,  6,  6,  6, 14,  6,  6,  6, 18],
                [6,  14, 14, 14, 14, 14, 14, 14, 14,  6],
                [6,  14, 14, 14, 14, 14, 14, 14, 14,  6],
                [6,  14, 14, 14, 14, 14, 14, 14, 14,  6],
                [6,  14, 14, 14, 14, 14, 14,  0, 14,  6],
                [6,  14, 14, 14, 14, 14, 14, 14, 14,  6],
                [6,  14, 14, 14, 14, 14, 14, 14, 14,  6],
                [6,  14, 14, 14, 14, 14, 14, 14, 14,  6],
                [6,  14, 14, 14, 14, 14, 14, 14, 14,  6],
                [18,  6,  6,  6,  6,  6,  6,  6,  6, 18]
              ],
              
    "up": "room1",
    "right": "none",
    "down": "none",
    "left": "none"
  },

  "room1":
  {
    "level":  [ 
                [18,  6,  6,  6,  6,  6,  6,  6,  6, 18],
                [6,   6, 14, 14, 14,  6, 14, 14, 14,  6],
                [6,  14, 14,  6, 14, 14, 14, 14, 14,  6],
                [6,  14, 14, 14, 14, 14, 14, 14, 14,  6],
                [6,  14, 14, 14, 14, 14, 14, 14, 14,  6],
                [14, 14, 14, 14, 14, 14, 14, 14, 14,  6],
                [6,  14, 14, 14, 14, 14, 14,  6, 14,  6],
                [6,  14, 14, 14,  0, 14,  0, 14, 14,  6],
                [6,  14, 14, 14,  0, 14,  0, 14, 14,  6],
                [18,  6,  6,  6,  6, 14,  6,  6,  6, 18] 
              ],
              
    "up": "none",
    "right": "none",
    "down": "start",
    "left": "room2"
  },

  "room2":
  {
    "level":  [ 
                [18,  6,  6,  6,  6,  6,  6,  6,  6, 18],
                [6,  14, 14, 14, 14, 14, 14, 14, 14,  0],
                [6,  14, 14, 14, 14, 14, 14, 14, 14,  0],
                [6,  14, 14, 14, 14, 14, 14, 14, 14,  0],
                [6,  14, 14, 14, 14, 14, 14, 14, 14,  0],
                [6,  14, 14, 14, 14, 14, 14, 14, 14, 14],
                [6,  14, 14, 14, 14, 14, 14, 14, 14,  0],
                [6,  14, 14, 14, 14, 14, 14, 14, 14,  0],
                [6,  14, 14, 14, 14, 14, 14, 14, 14,  0],
                [18,  6,  6,  6,  6,  6,  6,  6,  6, 18] 
              ],
              
    "up": "none",
    "right": "room1",
    "down": "none",
    "left": "none"
  }

  
  
}
